<==============>
|PBrt.......ytP|
|bt..........tY|
|PR..........RP|
|Yr.....y....Yy|
}==]sosososos[={
|t....t.B.t....|
|..[=]..,...[=={
|.tbs..[+].....|
|t[=]...'...[=={
|esBt...s...bte|
L==============J