................
<=====T========>
|P....|........|
|.,.<=w==>.,.,.|
|.|.|e...|.|.|.|
|P|.L==>.'.|.|.|
|.|....|...|.|.|
|.|.<].L===J.|.|
|P|.|........|.|
|.'.'.[======J.|
|..............|
L==============J