................
<==============>
|P......t......|
|P......t......|
|P......t......|
|.......t......|
}].............|
|.......t......|
|P......t......|
|P......t......|
|P......t..e...|
L==============J