<==============>
|...H..........|
|V.............|
|.............V|
|..............|
|V....tPe......|
|..............|
|......s.......|
|......ss......|
|..............|
|....RBY.rby...|
L==============J