................
<============T=>
|.H..........|P|
|.[===T=].<==JP|
|.....|Y.ss...P|
|.oso.L=].os[]P|
|t.............|
|.o.[===>...[=={
|.......L=]t...|
|.[===].....[=={
|...t.......y.e|
L==============J