<============T=>
|PY.t........yP|
|bt..........tB|
|Pr..........RP|
|Y............y|
}==]sosososos[={
|t.............|
|.o.[===,...[=={
|t.....[+].....|
|.[===].'...[=={
|e.Bt.......b.e|
L==============J