................
<=====T========>
|P....|.H......|
|.,.<=w==>.,s,.|
|.|.|e...|.|.|.|
|P|.L==>.'.|.|.|
|.|....|...|.|.|
|.|.<]tL===J.|.|
|P|.|........|.|
|.'.'.[======J.|
|..............|
L==============J